
000000000000000000000000000000000000
000000000000000000000000000000000000
000000000000000000000000000000000000
000000000000000000000000000000000000
000000000000000000000000000000000000
000000000000000000000000000000000000
000000000000000000000000000000000000
000001111111111222111111111000000000
000001111111111441111111111000000000
000001166666666444444444411000000000
000001164666666666666664411000000000
000001166111111111111114411000000000
000001166111111111111114411000000000
000001166666611661144444411000000000
000001166664611661144644411000000000
000001111116611661144111111000000000
000001111116611661144111111000000000
000001166666611661164444411000000000
000001166664611661166664411000000000
000001111116611661111114411000000000
000001111116611661111114411000000000
000001144116666646666114411000000000
000001144116666666666114411000000000
000001144111111111111114411000000000
000001144111111111111114411000000000
000001144444444444444444411000000000
000001144444444446666644411000000000
000001111111111441111111111000000000
000001111111111333111111111000000000
000000000000000000000000000000000000
000000000000000000000000000000000000
000000000000000000000000000000000000
000000000000000000000000000000000000
000000000000000000000000000000000000
000000000000000000000000000000000000
000000000000000000000000000000000000